Rk,Date,raw_location,Opponent,Result,pass_cmp,pass_att,completion_pct,pass_yds,pass_td,rush_att,rush_yds,rush_avg,rush_tds,total_plays,total_yards,avg_yds,pass_first_downs,rush_first_downs,first_down_pens,total_first_downs,total_penalties,total_penalties_yds,total_fum,total_int,total_to
1,2023-09-02,H,Boise State,W (56-19),31,42,73.8,490,6,19,78,4.1,2,61,568,9.3,18,3,1,22,5,60,0,0,0
2,2023-09-09,H,Tulsa,W (43-10),30,40,75,454,3,22,109,5,3,62,563,9.1,20,6,5,31,7,93,1,1,2
3,2023-09-16,@,Michigan State,W (41-7),29,39,74.4,536,4,33,177,5.4,1,72,713,9.9,18,8,3,29,11,110,0,1,1
4,2023-09-23,H,California,W (59-32),23,32,71.9,389,4,30,140,4.7,2,62,529,8.5,15,8,0,23,9,83,0,1,1
5,2023-09-30,@,Arizona,W (31-24),30,40,75,363,0,26,111,4.3,4,66,474,7.2,17,8,2,27,12,125,1,0,1
6,2023-10-14,H,Oregon,W (36-33),23,38,60.5,316,4,23,99,4.3,1,61,415,6.8,16,6,2,24,5,45,0,1,1
7,2023-10-21,H,Arizona State,W (15-7),27,42,64.3,275,0,13,13,1,0,55,288,5.2,11,3,3,17,5,51,2,2,4
8,2023-10-28,@,Stanford,W (42-33),21,37,56.8,369,4,27,91,3.4,2,64,460,7.2,14,6,3,23,7,78,1,1,2
9,2023-11-04,@,Southern California,W (52-42),22,30,73.3,256,2,42,316,7.5,5,72,572,7.9,15,10,2,27,6,52,0,1,1
10,2023-11-11,H,Utah,W (35-28),24,42,57.1,332,2,33,125,3.8,2,75,457,6.1,14,9,4,27,11,100,1,0,1
11,2023-11-18,@,Oregon State,W (22-20),13,28,46.4,162,2,25,110,4.4,1,53,272,5.1,8,5,1,14,10,64,1,0,1
12,2023-11-25,H,Washington State,W (24-21),18,33,54.5,204,2,30,102,3.4,1,63,306,4.9,7,8,2,17,7,49,0,1,1
13,2023-12-01,N,Oregon,W (34-31),29,41,70.7,324,2,37,157,4.2,2,78,481,6.2,15,9,2,26,7,50,0,1,1
14,2024-01-01,N,Texas*,W (37-31),29,39,74.4,430,2,31,102,3.3,2,70,532,7.6,17,6,2,25,5,39,1,0,1
15,2024-01-08,N,Michigan*,L (13-34),27,51,52.9,255,1,20,46,2.3,0,71,301,4.2,13,2,2,17,5,30,0,2,2
1,2022-09-03,H,Kent State,W (45-20),29,44,65.9,393,4,34,132,3.9,2,78,525,6.7,19,8,2,29,5,52,1,0,1
2,2022-09-10,H,Portland State,W (52-6),23,33,69.7,376,2,40,241,6,5,73,617,8.5,17,14,1,32,9,90,0,1,1
3,2022-09-17,H,Michigan State,W (39-28),24,40,60,397,4,36,106,2.9,1,76,503,6.6,19,3,2,24,8,64,0,0,0
4,2022-09-24,H,Stanford,W (40-22),22,37,59.5,309,2,32,169,5.3,2,69,478,6.9,13,9,1,23,5,32,0,0,0
5,2022-09-30,@,UCLA,L (32-40),33,49,67.3,345,4,23,65,2.8,0,72,410,5.7,17,5,2,24,9,98,0,2,2
6,2022-10-08,@,Arizona State,L (38-45),34,54,63,324,0,33,134,4.1,5,87,458,5.3,19,9,4,32,4,36,0,1,1
7,2022-10-15,H,Arizona,W (49-39),36,44,81.8,516,4,29,79,2.7,3,73,595,8.2,22,7,2,31,4,43,0,0,0
8,2022-10-22,@,California,W (28-21),36,51,70.6,374,2,32,102,3.2,1,83,476,5.7,19,9,0,28,9,65,0,0,0
9,2022-11-04,H,Oregon State,W (24-21),30,52,57.7,298,1,24,100,4.2,2,76,398,5.2,16,6,2,24,9,97,0,1,1
10,2022-11-12,@,Oregon,W (37-34),26,35,74.3,408,2,22,114,5.2,2,57,522,9.2,15,7,1,23,5,25,0,1,1
11,2022-11-19,H,Colorado,W (54-7),23,38,60.5,295,2,43,280,6.5,5,81,575,7.1,15,13,1,29,5,35,0,1,1
12,2022-11-26,@,Washington State,W (51-33),25,43,58.1,485,3,24,218,9.1,4,67,703,10.5,15,14,1,30,10,104,1,1,2
13,2022-12-29,N,Texas*,W (27-20),32,55,58.2,287,2,28,158,5.6,1,83,445,5.4,16,9,0,25,7,45,0,1,1
1,2021-09-04,H,Montana,L (7-13),27,46,58.7,226,0,27,65,2.4,1,73,291,4,14,4,3,21,3,30,0,3,3
2,2021-09-11,@,Michigan,L (10-31),20,37,54.1,293,1,32,50,1.6,0,69,343,5,12,5,2,19,6,59,1,0,1
3,2021-09-18,H,Arkansas State,W (52-3),25,44,56.8,398,3,39,200,5.1,3,83,598,7.2,17,10,3,30,6,57,1,2,3
4,2021-09-25,H,California,W (31-24),19,32,59.4,234,2,30,92,3.1,2,62,326,5.3,11,5,2,18,7,62,1,0,1
5,2021-10-02,@,Oregon State,L (24-27),17,26,65.4,142,1,35,176,5,2,61,318,5.2,4,11,0,15,2,15,1,1,2
6,2021-10-16,H,UCLA,L (17-24),20,30,66.7,184,1,30,108,3.6,1,60,292,4.9,9,7,3,19,3,20,0,2,2
7,2021-10-22,@,Arizona,W (21-16),13,22,59.1,217,2,38,88,2.3,1,60,305,5.1,6,7,3,16,4,45,0,0,0
8,2021-10-30,@,Stanford,W (20-13),17,25,68,146,1,41,230,5.6,0,66,376,5.7,6,15,0,21,4,29,0,0,0
9,2021-11-06,H,Oregon,L (16-26),15,27,55.6,111,0,24,55,2.3,2,51,166,3.3,4,2,1,7,6,48,0,1,1
10,2021-11-13,H,Arizona State,L (30-35),19,33,57.6,171,1,30,95,3.2,3,63,266,4.2,8,6,3,17,1,3,1,1,2
11,2021-11-20,@,Colorado,L (17-20),34,56,60.7,388,2,28,38,1.4,0,84,426,5.1,16,5,1,22,7,70,2,2,4
12,2021-11-26,H,Washington State,L (13-40),17,31,54.8,190,1,14,10,0.7,1,45,200,4.4,8,2,0,10,3,41,0,4,4
1,2020-11-14,H,Oregon State,W (27-21),14,24,58.3,141,0,51,267,5.2,3,75,408,5.4,5,16,3,24,5,35,0,0,0
2,2020-11-21,H,Arizona,W (44-27),16,26,61.5,239,2,45,233,5.2,4,71,472,6.6,10,13,1,24,6,46,0,0,0
3,2020-11-28,H,Utah,W (24-21),23,38,60.5,272,2,26,88,3.4,1,64,360,5.6,15,4,1,20,6,51,0,3,3
4,2020-12-05,H,Stanford,L (26-31),15,23,65.2,254,0,34,117,3.4,3,57,371,6.5,10,8,1,19,4,30,0,0,0
1,2019-08-31,H,Eastern Washington,W (47-14),28,38,73.7,370,4,43,200,4.7,2,81,570,7,16,11,0,27,5,38,0,0,0
2,2019-09-07,H,California,L (19-20),18,30,60,162,0,46,186,4,1,76,348,4.6,9,12,2,23,6,62,1,1,2
3,2019-09-14,H,Hawaii,W (52-20),19,26,73.1,260,3,30,192,6.4,4,56,452,8.1,11,10,1,22,3,30,0,0,0
4,2019-09-21,@,Brigham Young,W (45-19),24,28,85.7,290,3,39,187,4.8,1,67,477,7.1,14,11,2,27,10,79,1,1,2
5,2019-09-28,H,Southern California,W (28-14),16,26,61.5,180,0,34,194,5.7,3,60,374,6.2,7,8,1,16,7,44,1,0,1
6,2019-10-05,@,Stanford,L (13-23),16,36,44.4,206,1,22,88,4,0,58,294,5.1,7,6,2,15,4,34,0,1,1
7,2019-10-12,@,Arizona,W (51-27),15,22,68.2,243,2,45,207,4.6,3,67,450,6.7,8,9,1,18,8,67,1,0,1
8,2019-10-19,H,Oregon,L (31-35),23,30,76.7,289,3,33,144,4.4,1,63,433,6.9,11,8,1,20,7,62,0,0,0
9,2019-11-02,H,Utah,L (28-33),29,52,55.8,316,4,22,53,2.4,0,74,369,5,16,4,1,21,6,25,1,2,3
10,2019-11-08,@,Oregon State,W (19-7),16,33,48.5,175,0,48,245,5.1,2,81,420,5.2,6,14,0,20,9,70,0,2,2
11,2019-11-23,@,Colorado,L (14-20),21,35,60,206,1,32,32,1,1,67,238,3.6,12,4,1,17,9,68,0,1,1
12,2019-11-29,H,Washington State,W (31-13),15,22,68.2,244,1,29,98,3.4,3,51,342,6.7,10,3,3,16,4,50,1,0,1
13,2019-12-21,N,Boise State*,W (38-7),23,33,69.7,223,2,35,118,3.4,3,68,341,5,12,9,1,22,1,10,0,0,0
1,2018-09-01,N,Auburn,L (16-21),18,32,56.3,296,1,33,102,3.1,0,65,398,6.1,12,8,4,24,10,95,1,1,2
2,2018-09-08,H,North Dakota,W (45-3),31,45,68.9,437,3,34,195,5.7,3,79,632,8,17,8,0,25,5,45,0,2,2
3,2018-09-15,@,Utah,W (21-7),14,24,58.3,155,1,41,172,4.2,2,65,327,5,10,6,2,18,5,35,0,1,1
4,2018-09-22,H,Arizona State,W (27-20),15,23,65.2,202,3,39,171,4.4,0,62,373,6,11,12,3,26,3,30,0,1,1
5,2018-09-29,H,Brigham Young,W (35-7),23,25,92,277,1,37,187,5.1,4,62,464,7.5,15,10,1,26,5,40,1,0,1
6,2018-10-06,@,UCLA,W (31-24),18,26,69.2,265,1,55,197,3.6,3,81,462,5.7,11,13,2,26,1,10,0,1,1
7,2018-10-13,@,Oregon,L (27-30),15,25,60,243,1,45,194,4.3,2,70,437,6.2,13,7,2,22,5,38,0,1,1
8,2018-10-20,H,Colorado,W (27-13),15,25,60,150,1,40,201,5,2,65,351,5.4,8,12,3,23,3,45,1,1,2
9,2018-10-27,@,California,L (10-12),12,25,48,159,1,33,91,2.8,0,58,250,4.3,8,4,1,13,4,18,0,2,2
10,2018-11-03,H,Stanford,W (27-23),16,27,59.3,194,1,45,177,3.9,2,72,371,5.2,11,6,2,19,8,85,0,0,0
11,2018-11-17,H,Oregon State,W (42-23),18,25,72,228,3,42,275,6.5,3,67,503,7.5,11,10,1,22,4,40,0,0,0
12,2018-11-23,@,Washington State,W (28-15),12,15,80,229,1,44,258,5.9,3,59,487,8.3,7,13,0,20,6,47,2,1,3
13,2018-11-30,N,Utah,W (10-3),21,33,63.6,187,0,40,119,3,0,73,306,4.2,8,11,0,19,4,45,0,1,1
14,2019-01-01,N,Ohio State*,L (23-28),36,55,65.5,315,1,36,129,3.6,2,91,444,4.9,14,10,3,27,6,46,0,0,0
1,2017-09-01,@,Rutgers,W (30-14),17,30,56.7,284,2,24,84,3.5,0,54,368,6.8,12,5,0,17,6,56,0,0,0
2,2017-09-09,H,Montana,W (63-7),24,28,85.7,293,2,37,213,5.8,5,65,506,7.8,15,10,0,25,6,50,0,1,1
3,2017-09-16,H,Fresno State,W (48-16),25,28,89.3,328,4,30,92,3.1,2,58,420,7.2,14,4,3,21,4,41,2,0,2
4,2017-09-23,@,Colorado,W (37-10),11,21,52.4,160,1,39,254,6.5,3,60,414,6.9,8,11,1,20,3,20,0,1,1
5,2017-09-30,@,Oregon State,W (42-7),26,34,76.5,293,3,41,216,5.3,3,75,509,6.8,13,13,6,32,3,21,0,1,1
6,2017-10-07,H,California,W (38-7),27,42,64.3,215,2,38,162,4.3,3,80,377,4.7,13,8,1,22,6,40,1,0,1
7,2017-10-14,@,Arizona State,L (7-13),17,30,56.7,139,0,31,91,2.9,1,61,230,3.8,9,5,0,14,3,15,0,0,0
8,2017-10-28,H,UCLA,W (44-23),9,12,75,109,0,58,333,5.7,5,70,442,6.3,6,15,3,24,4,47,1,1,2
9,2017-11-04,H,Oregon,W (38-3),11,19,57.9,204,2,39,247,6.3,2,58,451,7.8,7,11,1,19,4,35,0,1,1
10,2017-11-10,@,Stanford,L (22-30),17,23,73.9,190,0,33,135,4.1,3,56,325,5.8,8,9,3,20,7,73,1,0,1
11,2017-11-18,H,Utah,W (33-30),26,35,74.3,354,2,32,123,3.8,2,67,477,7.1,16,6,1,23,2,10,0,0,0
12,2017-11-25,H,Washington State,W (41-14),11,17,64.7,93,0,45,328,7.3,5,62,421,6.8,5,14,1,20,2,15,0,0,0
13,2017-12-30,@,Penn State*,L (28-35),19,29,65.5,227,1,26,104,4,3,55,331,6,8,5,1,14,4,22,1,0,1
1,2016-09-03,H,Rutgers,W (48-13),20,29,69,289,4,30,91,3,0,59,380,6.4,11,5,1,17,3,30,0,1,1
2,2016-09-10,H,Idaho,W (59-14),27,33,81.8,356,6,30,126,4.2,1,63,482,7.7,20,6,1,27,4,30,1,0,1
3,2016-09-17,H,Portland State,W (41-3),14,22,63.6,194,5,35,213,6.1,1,57,407,7.1,8,11,1,20,5,65,1,0,1
4,2016-09-24,@,Arizona,W (35-28),14,21,66.7,160,2,51,352,6.9,3,72,512,7.1,7,16,1,24,8,63,0,1,1
5,2016-09-30,H,Stanford,W (44-6),15,21,71.4,210,3,41,214,5.2,3,62,424,6.8,9,10,3,22,5,60,0,0,0
6,2016-10-08,@,Oregon,W (70-21),22,28,78.6,304,6,45,378,8.4,4,73,682,9.3,13,14,3,30,12,89,0,0,0
7,2016-10-22,H,Oregon State,W (41-17),15,31,48.4,300,3,39,219,5.6,2,70,519,7.4,13,12,1,26,2,10,1,0,1
8,2016-10-29,@,Utah,W (31-24),12,20,60,186,2,36,199,5.5,1,56,385,6.9,12,9,1,22,4,21,0,1,1
9,2016-11-05,@,California,W (66-27),20,29,69,417,7,44,287,6.5,2,73,704,9.6,13,13,5,31,5,35,1,0,1
10,2016-11-12,H,Southern California,L (13-26),17,37,45.9,259,1,27,17,0.6,0,64,276,4.3,9,4,0,13,3,35,0,2,2
11,2016-11-19,H,Arizona State,W (44-18),27,44,61.4,338,2,33,201,6.1,2,77,539,7,14,11,1,26,7,70,0,2,2
12,2016-11-25,@,Washington State,W (45-17),22,31,71,342,3,35,168,4.8,3,66,510,7.7,13,8,1,22,9,75,1,0,1
13,2016-12-02,N,Colorado,W (41-10),9,24,37.5,118,2,54,265,4.9,2,78,383,4.9,4,17,1,22,3,35,0,0,0
14,2016-12-31,N,Alabama*,L (7-24),20,38,52.6,150,1,29,44,1.5,0,67,194,2.9,8,6,0,14,3,10,1,2,3
1,2015-09-04,@,Boise State,L (13-16),20,35,57.1,150,0,22,29,1.3,0,57,179,3.1,8,1,3,12,5,32,0,1,1
2,2015-09-12,H,Sacramento State,W (49-0),17,25,68,326,2,36,218,6.1,5,61,544,8.9,10,10,3,23,3,30,1,0,1
3,2015-09-19,H,Utah State,W (31-17),22,31,71,368,3,35,74,2.1,1,66,442,6.7,17,3,0,20,3,38,2,1,3
4,2015-09-26,H,California,L (24-30),17,28,60.7,152,0,27,107,4,2,55,259,4.7,9,6,0,15,5,53,3,2,5
5,2015-10-08,@,Southern California,W (17-12),17,33,51.5,164,1,36,135,3.8,1,69,299,4.3,7,9,1,17,7,60,0,1,1
6,2015-10-17,H,Oregon,L (20-26),20,32,62.5,205,1,30,180,6,1,62,385,6.2,8,7,2,17,8,64,0,1,1
7,2015-10-24,@,Stanford,L (14-31),9,21,42.9,118,0,24,113,4.7,2,45,231,5.1,5,6,0,11,3,30,0,0,0
8,2015-10-31,H,Arizona,W (49-3),17,25,68,267,4,36,201,5.6,3,61,468,7.7,14,8,0,22,4,49,0,0,0
9,2015-11-07,H,Utah,L (23-34),23,39,59,257,1,39,124,3.2,1,78,381,4.9,12,7,1,20,6,65,3,1,4
10,2015-11-14,@,Arizona State,L (17-27),28,52,53.8,405,1,34,142,4.2,1,86,547,6.4,19,8,0,27,7,60,1,3,4
11,2015-11-21,@,Oregon State,W (52-7),18,21,85.7,211,4,59,271,4.6,2,80,482,6,12,16,0,28,5,40,0,0,0
12,2015-11-27,H,Washington State,W (45-10),14,20,70,203,0,55,240,4.4,3,75,443,5.9,7,14,1,22,10,80,0,1,1
13,2015-12-26,N,Southern Mississippi*,W (44-31),23,34,67.6,284,0,44,296,6.7,5,78,580,7.4,12,13,2,27,5,50,1,0,1
1,2014-08-30,@,Hawaii,W (17-16),10,26,38.5,162,1,48,174,3.6,1,74,336,4.5,5,12,2,19,5,35,0,0,0
2,2014-09-06,H,Eastern Washington,W (59-52),14,24,58.3,180,1,57,356,6.2,7,81,536,6.6,10,14,2,26,10,100,0,0,0
3,2014-09-13,H,Illinois,W (44-19),16,22,72.7,219,1,58,245,4.2,2,80,464,5.8,7,14,4,25,8,73,1,0,1
4,2014-09-20,H,Georgia State,W (45-14),19,27,70.4,154,3,41,182,4.4,2,68,336,4.9,8,9,0,17,6,53,0,0,0
5,2014-09-27,H,Stanford,L (13-20),15,30,50,98,1,38,81,2.1,0,68,179,2.6,4,7,4,15,10,84,0,0,0
6,2014-10-11,@,California,W (31-7),22,29,75.9,273,3,38,111,2.9,0,67,384,5.7,11,7,0,18,8,76,0,0,0
7,2014-10-18,@,Oregon,L (20-45),24,38,63.2,184,1,36,133,3.7,1,74,317,4.3,10,8,2,20,4,24,1,1,2
8,2014-10-25,H,Arizona State,L (10-24),18,26,69.2,139,0,46,151,3.3,0,72,290,4,7,12,0,19,4,30,1,2,3
9,2014-11-01,@,Colorado,W (38-23),13,19,68.4,206,2,40,236,5.9,1,59,442,7.5,6,8,0,14,3,24,3,0,3
10,2014-11-08,H,UCLA,L (30-44),14,24,58.3,155,0,48,211,4.4,2,72,366,5.1,6,15,1,22,7,65,0,1,1
11,2014-11-15,@,Arizona,L (26-27),21,30,70,259,1,60,245,4.1,2,90,504,5.6,12,13,0,25,13,111,3,0,3
12,2014-11-22,H,Oregon State,W (37-13),19,24,79.2,255,2,35,226,6.5,2,59,481,8.2,8,8,0,16,6,60,1,0,1
13,2014-11-29,@,Washington State,W (31-13),25,41,61,249,2,37,188,5.1,2,78,437,5.6,13,5,4,22,7,60,0,1,1
14,2015-01-02,N,Oklahoma State*,L (22-30),25,40,62.5,268,1,25,101,4,1,65,369,5.7,14,7,1,22,7,70,1,1,2
1,2013-08-31,H,Boise State,W (38-6),23,31,74.2,324,2,54,268,5,3,85,592,7,15,17,1,33,8,61,0,1,1
2,2013-09-14,N,Illinois,W (34-24),28,35,80,342,2,50,273,5.5,2,85,615,7.2,15,13,2,30,12,104,2,0,2
3,2013-09-21,H,Idaho State,W (56-0),21,28,75,310,4,53,370,7,4,81,680,8.4,11,18,1,30,16,130,1,0,1
4,2013-09-28,H,Arizona,W (31-13),14,25,56,165,2,61,244,4,2,86,409,4.8,8,12,4,24,7,75,0,1,1
5,2013-10-05,@,Stanford,L (28-31),33,48,68.8,350,2,40,139,3.5,2,88,489,5.6,17,11,2,30,10,89,0,1,1
6,2013-10-12,H,Oregon,L (24-45),19,32,59.4,182,1,42,194,4.6,2,74,376,5.1,7,12,1,20,5,54,1,1,2
7,2013-10-19,@,Arizona State,L (24-53),16,40,40,217,2,25,-5,-0.2,1,65,212,3.3,9,2,1,12,8,54,1,0,1
8,2013-10-26,H,California,W (41-17),21,34,61.8,380,2,44,262,6,3,78,642,8.2,15,8,1,24,6,63,0,0,0
9,2013-11-09,H,Colorado,W (59-7),22,29,75.9,312,2,51,316,6.2,4,80,628,7.9,15,13,0,28,6,50,0,0,0
10,2013-11-15,@,UCLA,L (31-41),25,40,62.5,331,3,36,101,2.8,1,76,432,5.7,12,8,1,21,11,113,2,2,4
11,2013-11-23,@,Oregon State,W (69-27),15,24,62.5,162,1,58,530,9.1,7,82,692,8.4,8,18,1,27,4,43,0,0,0
12,2013-11-29,H,Washington State,W (27-17),15,20,75,181,1,53,224,4.2,2,73,405,5.5,8,13,0,21,7,72,1,1,2
13,2013-12-27,N,Brigham Young*,W (31-16),18,27,66.7,129,1,43,190,4.4,2,70,319,4.6,8,11,0,19,5,24,0,1,1